# meta
cols=10
rows=5
padding=0

# grid
0 0 0 0 0 0 0 0 0 0
0 0 0 0 0 1 0 0 0 0
0 0 0 0 0 0 0 0 0 0
3 0 3 0 3 0 3 0 3 0
0 0 0 0 0 0 0 0 0 0